..............
.S   .   .   .
. ..   .   .G.
. ............
. .          .
. .          .
. .          .
. .          .
. ............
.           G.
..............
